9 6
WWWWWW
W...EW
W.WWWW
W....W
WWWW.W
W....W
W.WWWW
W...SW
WWWWWW

0.5 0.3 0.2
0.9 0.05 0.05